WIDTH=20
HEIGHT=12
BALL_COLORS=1.0,0.4,0.4;0.4,0.4,1.0

####################
#       #          #
# B   a #  B    1  #
#   #   #          #
#   #####          #
#            #     #
#            #     #
##############!!!!!#
#                  #
# A             2  #
#                  #
####################
