WIDTH=19
HEIGHT=13
BALL_COLORS=1.0,0.4,0.4;0.4,0.4,1.0;0.4,1.0,0.4

###################
#     #     #     #
#  1  #  B  # a   #
#     #     #     #
#  ####  #######  #
#   #             #
# b # C         2 #
#   #             #
##!!############@@#
#                 #
#      A   3      #
#                 #
###################
